........
........
........
........
........
........
........
...cr...
...rg...
...rb...
..gyybc.
.mmgbmcy
