0
........
........
....*...
....###.
..y...#.
.rr.c.#.
.###cg#.
.#..ym#.
.#..ym#.
.#.r###.
.#cg..#.
.#bgbm#.
