0
........
........
........
........
..mbm...
..mym...
..gby...
..gbr...
..yyg...
.m###m..
.rcc#m..
.rcb#bb.
