17
........
........
...m....
...m....
...bg...
...gb...
...bg...
...mr...
...mr...
...bm...
...mb...
...mb...
