15
........
........
........
........
........
....M...
..Ymbb..
..gbmc..
..gccy..
.mrgrry.
########
.RGBCMY.
