0
........
........
........
........
..c..g..
..g..c..
..c..r..
..r..g..
..c..c..
..B..B..
.bG..Gb.
.rR..Rc.
