........
........
........
........
........
........
........
........
........
........
.y...yy.
yy.y.yy.
