........
........
........
........
........
........
........
........
........
.mc..cm.
.cm..mc.
.mcc.cm.
