........
........
........
........
........
........
........
........
........
.r.r....
.r.br...
rb.bb.b.
