........
........
........
........
...ry...
...yr...
...ry...
...rr...
..#bg#..
..#bg#..
.r#gb#r.
.r#bg#r.
