86
........
........
........
........
........
........
..g..r..
..y..y..
..b..b..
..b..b..
r.r..g.g
yybyybyy
