1280
........
........
........
........
........
..r..c..
..g..gr.
..gc.by.
..cmcrr.
..myybcc
.myggbmy
rrgrrmmy
